BBBBBBBBBBBBBBBBBBBBBBBB
BBBBBBBBBBBBBBBBBOOOOBBB
BBBBBBBBBBOBBBBBBOBBBBBB
BBBOBBBBBBBBBBBBOBBBBBBB
BBBBBBBBBBBBBBOOBBBBBBBB
BBBBBBBBBBBOOOOBBBBBBBBB
BOBBBBBBBBBBBBBBBBOBBBBB
BBBBBBBBBBBBBBBOBBBBBBBB
BBBBBBBBBBBBBBBBBBBBBBBB
BBBBBBBJBBBOBBBBBBBBBBBB
BBBOBBBBBBBOBBBBBBOBBBBB
BBBBBBBBBBBOBBBBBBBBBBBB
OOOOOOOOOOOOBBBBBOOOOOOO
BBBBBBBBBBBBBBBBBBBBBBBB
BBBBBBBBBBBBBBBBBBBBBBBB
BBBBBBBBBBBBBBBBBBBBBBBM

