BBBBBBBBBBBBBBBBBBBBBBBB
BBBBBBBBBBBBBBBBBPPPPBBB
BBBBBBBBBBOBBBBBBPBBBBBB
BBBOBBBBBBBBBBBBPBBBBBBB
BBBBBMBBBBBBBBPPBBBBBBBB
BBBBBBBBBBBPPPPBBBBBBBBB
BOBBBBBBBBBBBBBBBBOBBBBB
BBBBBBBBBBBBBBBOBBBBBBBB
BBBBBBBBBBMBBBBBBBBBBBBB
BBBBBBBJBBBPBBBBBBBBBBBB
BBBOBBBBBBBPBBBBBBOBBBBB
BBBBBBBBBBBPBBBBBBBBBBBB
PPPPPPPPPPPPBBBBBBBBBBBB
BBBBBBBBBBBBBBBBBBBBBBBB
BBBBBBBBBBBBBBBBBBBBBBBB
BBBBBBBBBBBBBBBBBBBBBBBB

