MBBBBBBBBBBBBBBBBBBBBBBB
BBBBBBBBBBBBBBBBBOOOOBBB
BBBBBBBBBBOBBBBBBOBBBBBB
BBBOBBBBBBBBBBBBOBBBBPBB
BBBBBPBBBBBBBBOOBBBMBBBB
BBBBBBBBBBBOOOOBBBBBBBBB
BOBBBBBBBBBBBBBBBBOBBBBB
BBBBBBBBBBBBBBBOBBBBBBBB
BBBBBBBBBBBBBBBBBBBBBBBB
BBBBBBBJBBBOBBBBBBBBBBBB
BBBOBBBBBBBOBBBBBBOBBBBB
BBBBBBBBBBBOBBBBBBBBBBBB
OOOOOOOOOOOOBBBBBBBBBBBB
BBBBBBBBBBBBBBBBBBMBBBBB
BBBBMBBBBBBBBBBBBBBBBBBB
BBBBBBBBBBBBBBBBBBBBBBBB

