BBBBBBBBBBBBBBBBBBBBBBBB
BBJBBBBBBBBBBBBBBOOOOBBB
BBBBBBBBBBOBBBBBBOBBBBBB
BBBOBBBBBBBBBBBBOBBBBPBB
BBBBBBBBBBBBBBOOBBBBBBMB
BBBBBBBBBBBOOOOBBBBBBBBB
BOBBBMBBBBBBBBBBBBOBBBBB
BBBOBBBBBBBBBBBOBBBBBBBB
BBBOBBBBBBBBBBBBBBBBBBBB
BOOOBBBBMBBOBBBBBMBBBBBB
BBBOBBBBBBBOBBBBBBOBBBBB
BBBBOBBBBBBOBBBBMBBBBBBB
BBBBBOOOOOOOBBBBBBBBBBBB
BBBBBBBBBBBOOBBBBBBBBBBB
BBBBBBBBBBBBOBBBBBBMBBBB
BBBBBBBBBBBBBBBBBBBBBBBB